1111111111111
1A000000000A1
1000000000001
1000111110001
1000000000001
1000000000001
1000000000001
10000E0000001
1000000000001
1001111111001
100000C000001
10000000000P1
1111111111111
